111111
1P0001
111101
1C1CE1
111111