11111111
1P000001
1C000CE1
1000C1C1
11111111