111111
1P0001
1C0C01
1E0001
111111