111111111
1P0C00011
100000101
1E000C011
111111111